The Haunted Record Player
An Interactive Fiction by Kyle Axt
Release 1 / Serial number 141028 / Inform 7 build 6L38 (I6/v6.33 lib 6/12N) SD

Foyer
The entranceway to the house.  The old wooden floor is dusty and there is a coat hanger that looks like its falling apart.  There's also an old painting hung on the wall.

You can still hear your friends talking outside the house.

>ask
What do you want to ask yourself for?

>n
You can't see any such thing.

>n
South Hallway
This is the hallway that leads to the rest of the house.

>n
You can't go that way.

>n
You can't go that way.

* * *

The Haunted Record Player
An Interactive Fiction by Kyle Axt
Release 1 / Serial number 141028 / Inform 7 build 6L38 (I6/v6.33 lib 6/12N) SD

Foyer
The entranceway to the house.  The old wooden floor is dusty and there is a coat hanger that looks like its falling apart.  There's also an old painting hung on the wall.

You can still hear your friends talking outside the house.

>n
South Hallway
This is the hallway that leads to the rest of the house.

>n
Music Room
This room is filled with a bunch of random insturments.  There is a record player in the middle.  It seems to be pretty important since it is in the center of the room.

>get reader pin
Taken.

>combine reader pin with not working record player
You put the reader pin in the record player.

>undo
Music room
[Previous turn undone.]

>combine not working record player with reader pin
You put the reader pin in the record player.

>rules on
Rules tracing now switched on. Type "rules off" to switch it off again, or "rules all" to include even rules which do not apply.

>combine not working record player with reader pin
You can't see any such thing.

>undo
Music room
[Previous turn undone.]

>combine record player with reader pin
You can't see any such thing.

>undo
Music room
[Previous turn undone.]

>undo
Music room
[Previous turn undone.]

>undo
Entrance Hallway
[Previous turn undone.]

>n
Music room

* * *

>combine reader pin with not working record player
You put the reader pin in the record player.

>x record
The Not Working Record Player is empty.

>x record player
The Not Working Record Player is empty.

* * *

>x record
The Not Working Record Player is empty.

* * *

>x record player
The Not Working Record Player is empty.

I beg your pardon?

I beg your pardon?

* * *

>x playable
You can't see any such thing.

* * *

>x record player
The Record Player is empty.

* * *

>n
Music Room
This room is filled with a bunch of random insturments.  There is a record player in the middle.  It seems to be pretty important since it is in the center of the room.

>n
North Bedroom Hallway

>n
You can't go that way.

>s
You can't go that way.

>s
You can't go that way.

>w
You can't go that way.

>e
You can't go that way.

* * *

>n
North Bedroom Hallway

>e
You can't go that way.

>s
Music room

>s
Entrance Hallway

>go to music room
You can't see any such thing.

>go to Music room
You can't see any such thing.

I beg your pardon?

* * *

>combine not working record player with reader pin
You put the reader pin in the record player.

>x record player
You see nothing special about Playable Record player.

* * *

>n
Music Room
This room is filled with a bunch of random insturments.  There is a record player in the middle.  It seems to be pretty important since it is in the center of the room.

>e
East Bedroom Hallway

>w
Music room
You can see a Blue Record and a Not Working Record Player (in which is a Reader Pin) here.

>w
Library
This room is full of books.  Well... It is a library.

>e
Music room
You can see a Blue Record and a Not Working Record Player (in which is a Reader Pin) here.

>e
East Bedroom Hallway

>e
You can't go that way.

>e
You can't go that way.

* * *

>n
Music Room
This room is filled with a bunch of random insturments.  There is a record player in the middle.  It seems to be pretty important since it is in the center of the room.

>x record player
It's an old record player.  You might be able to play some music with this thing.  

In the Not Working Record Player is a Reader Pin.

>get reader pin
Taken.

>combine reader pin with record player
You put the reader pin in the record player.

* * *

>n
South Hallway
This is the hallway that leads to the rest of the house.

>take vase
When you picked it up, it slid out of your hands and shattered into a million pieces on the floor.  Good thing no one lives here anymore.  Or maybe someone does?

>x vase
You can't see any such thing.

* * *

The Haunted Record Player
An Interactive Fiction by Kyle Axt
Release 1 / Serial number 141028 / Inform 7 build 6L38 (I6/v6.33 lib 6/12N) SD

Foyer
The entranceway to the house.  The old wooden floor is dusty and there is a coat hanger that looks like its falling apart.  There's also an old painting hung on the wall.

You can still hear your friends talking outside the house.

>s
You can't go that way.

>n
You can't go that way.

I beg your pardon?

>w
You can't go that way.

* * *

>e
You can't go that way.

I beg your pardon?

>s
You can't go that way.

>a
That's not a verb I recognise.

>d
You can't go that way.

>f
That's not a verb I recognise.

>e
You can't go that way.

>w
You can't go that way.

I beg your pardon?

>a
That's not a verb I recognise.

>sdf
That's not a verb I recognise.

>sd
That's not a verb I recognise.

>ff
That's not a verb I recognise.

>f
That's not a verb I recognise.

I beg your pardon?

>rew
That's not a verb I recognise.

I beg your pardon?

>ww
That's not a verb I recognise.

I beg your pardon?

>wq
That's not a verb I recognise.

I beg your pardon?

* * *

>s
You can't go that way.

I beg your pardon?

>df
That's not a verb I recognise.

I beg your pardon?

>br
That's not a verb I recognise.

I beg your pardon?

>r
That's not a verb I recognise.

>r
That's not a verb I recognise.

I beg your pardon?

* * *

>a
That's not a verb I recognise.

>r
That's not a verb I recognise.

* * *

I beg your pardon?

>ger
That's not a verb I recognise.

>g
That's not a verb I recognise.

I beg your pardon?

>e
You can't go that way.

>g
You can't go that way.

I beg your pardon?

>g
You can't go that way.

* * *

I beg your pardon?

>ak
That's not a verb I recognise.

>sn
That's not a verb I recognise.

>;
That's not a verb I recognise.

>edsa
That's not a verb I recognise.

>a
That's not a verb I recognise.

>sdef
That's not a verb I recognise.

I beg your pardon?

>sd
That's not a verb I recognise.

I beg your pardon?

>fa
That's not a verb I recognise.

>ds
That's not a verb I recognise.

I beg your pardon?

>h
That's not a verb I recognise.

I beg your pardon?

>d
You can't go that way.

I beg your pardon?

>hdd
That's not a verb I recognise.

>dfd
That's not a verb I recognise.

>dd
That's not a verb I recognise.

I beg your pardon?

* * *

>d
You can't go that way.

>gd
That's not a verb I recognise.

>d
You can't go that way.

>dn
That's not a verb I recognise.

>d
You can't go that way.

>d
You can't go that way.

>dbd
That's not a verb I recognise.

I beg your pardon?

>b
That's not a verb I recognise.

>d
You can't go that way.

* * *

I beg your pardon?

>ds
That's not a verb I recognise.

>d
You can't go that way.

>ds
That's not a verb I recognise.

* * *

I beg your pardon?

>fd
That's not a verb I recognise.

>df
That's not a verb I recognise.

>d
You can't go that way.

* * *

I beg your pardon?

>dd
That's not a verb I recognise.

>ed
That's not a verb I recognise.

>gd
That's not a verb I recognise.

I beg your pardon?

>dr
That's not a verb I recognise.

>hd
That's not a verb I recognise.

>dh
That's not a verb I recognise.

I beg your pardon?

* * *

>d
You can't go that way.

>h
That's not a verb I recognise.

* * *

>dr
That's not a verb I recognise.

I beg your pardon?

>rd
That's not a verb I recognise.

I beg your pardon?

>dw
That's not a verb I recognise.

I beg your pardon?

* * *

>dw
That's not a verb I recognise.

>d
You can't go that way.

>hd
That's not a verb I recognise.

I beg your pardon?

* * *

>r
That's not a verb I recognise.

>d
You can't go that way.

>yd
That's not a verb I recognise.

>jd
That's not a verb I recognise.

>td
That's not a verb I recognise.

>k
That's not a verb I recognise.

>d
You can't go that way.

>wd
That's not a verb I recognise.

I beg your pardon?

* * *

>wd
That's not a verb I recognise.

>kd
That's not a verb I recognise.

>s
You can't go that way.

* * *

>d
You can't go that way.

>bd
That's not a verb I recognise.

>d
You can't go that way.

* * *

I beg your pardon?

>gr
That's not a verb I recognise.

>g
That's not a verb I recognise.

>e
You can't go that way.

>h
That's not a verb I recognise.

* * *

>s
You can't go that way.

>e
You can't go that way.

* * *

>w
You can't go that way.

>n
Entrance Hallway
You can see a flower vase here.

>x vase
Theres a dead flower in here.

>take vase
Taken.

>i
You are carrying:
  a flower vase

>put vase on floor
You can't see any such thing.

>drop vase
Dropped.

>w
You can't go that way.

* * *

>e
You can't go that way.

>n
Music room
You can see a Blue Record and a Not Working Record Player (in which is a Reader Pin) here.

>take all
Blue Record: Taken.
Not Working Record Player: Taken.
Reader Pin: Taken.

>combine record player with reader pin
You put the reader pin in the record player.

>i
You are carrying:
  a Blue Record

>x room
You can't see any such thing.

>x music room
You can't see any such thing.

>play blue record with record player
You heard a loud sound coming from the library.  Why don't you go check it out?

>w
Library
Go east if you played the record.

>take all
(the Blue Record)
You already have that.

>e
Secret Room
The halls are made of stone.

>take all
(the Blue Record)
You already have that.

>n
You can't go that way.

>w
Library
Go east if you played the record.

I beg your pardon?

>e
Secret Room
The halls are made of stone.

>e
You Win

I beg your pardon?

* * *

The Haunted Record Player
An Interactive Fiction by Kyle Axt
Release 1 / Serial number 141028 / Inform 7 build 6L38 (I6/v6.33 lib 6/12N) SD

Foyer
The entranceway to the house.  The old wooden floor is dusty and there is a coat hanger that looks like its falling apart.  There's also an old painting hung on the wall.

You can still hear your friends talking outside the house.

>play
What do you want to play?